111111111111
1P00000C00E1
100111001111
100000000101
101110111111
1C000C0000C1
100000000001
111111111111
