1111111111111111
1P00C00010000CE1
1C00111001110001
1110010001000111
1000010000010001
1011110111101111
1000000C00000001
1000111000110001
1C00000000000C01
1111111111111111
