1111111111111111111111111111111
1E00001001000000000000000000001
10011110011110011110011110010C1
1000000000000001000001000001001
10010S1001111111111001111111111
1001001000001000001000000001001
1001111001111001111111001111001
1000001001001000001000001000001
1111001001001001111111001001111
1001001000000000001001000001001
1001111111111111001001111001001
1001000000000000001001000001001
1001111111111001111001001001001
1C00001000000001001000001000001
1001111111111001001111111111001
1001001000000001000001000001001
1001001001111111111001001111C01
10000010010000000C1001001000001
1001001001111111101001001001001
10010000000000000000000010010P1
1111111111111111111111111111111